year,team,conference,division,total.games,total.wins,total.losses,total.ties,conferenceGames.games,conferenceGames.wins,conferenceGames.losses,conferenceGames.ties,homeGames.games,homeGames.wins,homeGames.losses,homeGames.ties,awayGames.games,awayGames.wins,awayGames.losses,awayGames.ties
1977,Air Force,FBS Independents,,11,3,8,0,5,0,5,0,6,3,3,0,5,0,5,0
1977,Alabama,SEC,,12,11,1,0,7,7,0,0,6,6,0,0,5,4,1,0
1977,Alcorn State,SWAC,,11,3,8,0,6,2,4,0,5,2,3,0,6,1,5,0
1977,Appalachian State,Southern,,11,2,9,0,5,1,4,0,5,2,3,0,6,0,6,0
1977,Arizona,Western Athletic,,12,5,7,0,7,3,4,0,5,2,3,0,7,3,4,0
1977,Arizona State,Western Athletic,,12,9,3,0,7,6,1,0,7,6,1,0,4,3,1,0
1977,Arkansas,Southwest,,12,11,1,0,8,7,1,0,7,6,1,0,4,4,0,0
1977,Arkansas State,Southland,,11,7,4,0,5,2,3,0,5,3,2,0,6,4,2,0
1977,Army,FBS Independents,,11,7,4,0,7,4,3,0,9,6,3,0,2,1,1,0
1977,Auburn,SEC,,11,5,6,0,6,4,2,0,6,3,3,0,5,2,3,0
1977,Ball State,Mid-American,,11,9,2,0,6,5,1,0,5,5,0,0,6,4,2,0
1977,Baylor,Southwest,,11,5,6,0,8,3,5,0,7,5,2,0,4,0,4,0
1977,Boston College,FBS Independents,,11,6,5,0,8,5,3,0,5,4,1,0,6,2,4,0
1977,Bowling Green,Mid-American,,12,5,7,0,7,4,3,0,5,2,3,0,7,3,4,0
1977,Brown,Ivy,,9,7,2,0,7,5,2,0,5,5,0,0,4,2,2,0
1977,BYU,Western Athletic,,11,9,2,0,7,6,1,0,5,5,0,0,6,4,2,0
1977,California,Pac-8,,11,7,4,0,7,3,4,0,5,4,1,0,6,3,3,0
1977,Cal State Fullerton,PCAA,,11,4,7,0,4,0,4,0,4,2,2,0,7,2,5,0
1977,Central Michigan,Mid-American,,11,10,1,0,8,7,1,0,5,5,0,0,6,5,1,0
1977,Chattanooga,Southern,,11,9,2,0,5,4,1,0,5,4,1,0,6,5,1,0
1977,Cincinnati,FBS Independents,,11,6,5,0,7,4,3,0,6,5,1,0,5,1,4,0
1977,Clemson,ACC,,12,9,3,0,6,5,1,0,7,5,2,0,4,4,0,0
1977,Colgate,FBS Independents,,11,10,1,0,2,2,0,0,4,4,0,0,7,6,1,0
1977,Colorado,Big 8,,11,8,3,0,7,4,3,0,7,6,1,0,4,2,2,0
1977,Colorado State,Western Athletic,,12,10,2,0,7,5,2,0,7,6,1,0,5,4,1,0
1977,Columbia,Ivy,,9,2,7,0,7,1,6,0,6,2,4,0,3,0,3,0
1977,Cornell,Ivy,,9,1,8,0,7,1,6,0,5,1,4,0,4,0,4,0
1977,Dartmouth,Ivy,,9,6,3,0,7,4,3,0,4,3,1,0,5,3,2,0
1977,Drake,Missouri Valley,,11,2,9,0,5,1,4,0,5,1,4,0,6,1,5,0
1977,Duke,ACC,,11,5,6,0,6,2,4,0,5,1,4,0,6,4,2,0
1977,East Carolina,FBS Independents,,11,8,3,0,3,1,2,0,4,3,1,0,7,5,2,0
1977,Eastern Michigan,Mid-American,,11,8,3,0,7,4,3,0,7,6,1,0,4,2,2,0
1977,Florida,SEC,,11,6,5,0,6,3,3,0,5,3,2,0,6,3,3,0
1977,Florida State,FBS Independents,,12,10,2,0,7,5,2,0,5,4,1,0,6,5,1,0
1977,Fresno State,PCAA,,11,9,2,0,4,4,0,0,6,5,1,0,5,4,1,0
1977,Furman,Southern,,11,4,7,0,6,3,3,0,4,3,1,0,7,1,6,0
1977,Georgia,SEC,,11,5,6,0,6,2,4,0,6,3,3,0,5,2,3,0
1977,Georgia Tech,FBS Independents,,11,6,5,0,6,3,3,0,5,4,1,0,6,2,4,0
1977,Grambling,SWAC,,11,10,1,0,6,6,0,0,6,6,0,0,5,4,1,0
1977,Harvard,Ivy,,9,4,5,0,7,4,3,0,5,2,3,0,4,2,2,0
1977,Hawai'i,FBS Independents,,11,5,6,0,2,1,1,0,9,5,4,0,2,0,2,0
1977,Holy Cross,FBS Independents,,11,2,9,0,4,1,3,0,5,1,4,0,6,1,5,0
1977,Houston,Southwest,,11,6,5,0,8,4,4,0,5,3,2,0,6,3,3,0
1977,Illinois,Big Ten,,11,3,8,0,8,2,6,0,6,2,4,0,5,1,4,0
1977,Illinois State,FBS Independents,,11,3,8,0,1,0,1,0,4,3,1,0,7,0,7,0
1977,Indiana,Big Ten,,11,5,6,0,8,4,4,0,5,3,2,0,6,2,4,0
1977,Indiana State,FBS Independents,,10,3,7,0,2,1,1,0,4,1,3,0,6,2,4,0
1977,Iowa,Big Ten,,11,4,7,0,8,3,5,0,7,3,4,0,4,1,3,0
1977,Iowa State,Big 8,,12,8,4,0,7,5,2,0,6,5,1,0,5,3,2,0
1977,Jackson State,SWAC,,11,8,3,0,6,5,1,0,6,4,2,0,5,4,1,0
1977,Kansas,Big 8,,11,3,8,0,7,2,5,0,4,3,1,0,7,0,7,0
1977,Kansas State,Big 8,,11,1,10,0,7,0,7,0,5,0,5,0,6,1,5,0
1977,Kent State,Mid-American,,11,6,5,0,9,5,4,0,6,2,4,0,5,4,1,0
1977,Kentucky,SEC,,11,10,1,0,6,6,0,0,5,5,0,0,6,5,1,0
1977,Lamar,Southland,,11,2,9,0,5,1,4,0,5,1,4,0,6,1,5,0
1977,Long Beach State,PCAA,,10,4,6,0,4,1,3,0,6,3,3,0,4,1,3,0
1977,Louisiana,Southland,,12,7,5,0,5,3,2,0,5,5,0,0,7,2,5,0
1977,Louisiana Monroe,FBS Independents,,11,2,9,0,2,0,2,0,4,0,4,0,7,2,5,0
1977,Louisiana Tech,Southland,,12,10,2,0,5,4,1,0,6,5,1,0,5,4,1,0
1977,Louisville,FBS Independents,,12,7,5,0,4,2,2,0,6,5,1,0,5,2,3,0
1977,LSU,SEC,,12,8,4,0,6,4,2,0,7,5,2,0,4,3,1,0
1977,Marshall,Southern,,11,2,9,0,4,0,4,0,5,2,3,0,6,0,6,0
1977,Maryland,ACC,,12,8,4,0,6,4,2,0,6,4,2,0,5,3,2,0
1977,McNeese,Southland,,11,6,5,0,5,2,3,0,7,4,3,0,4,2,2,0
1977,Memphis,FBS Independents,,11,6,5,0,7,4,3,0,7,5,2,0,4,1,3,0
1977,Miami,FBS Independents,,11,3,8,0,5,1,4,0,5,2,3,0,6,1,5,0
1977,Miami (OH),Mid-American,,11,10,1,0,5,5,0,0,3,3,0,0,8,7,1,0
1977,Michigan,Big Ten,,12,10,2,0,8,7,1,0,7,7,0,0,4,3,1,0
1977,Michigan State,Big Ten,,11,8,3,0,8,7,1,0,7,5,2,0,4,3,1,0
1977,Minnesota,Big Ten,,12,7,5,0,8,4,4,0,7,6,1,0,4,1,3,0
1977,Mississippi State,SEC,,11,5,6,0,6,2,4,0,5,2,3,0,6,3,3,0
1977,Mississippi Valley State,SWAC,,10,5,5,0,6,2,4,0,5,3,2,0,5,2,3,0
1977,Missouri,Big 8,,11,4,7,0,7,3,4,0,6,2,4,0,5,2,3,0
1977,Navy,FBS Independents,,11,5,6,0,7,3,4,0,6,5,1,0,5,0,5,0
1977,NC State,ACC,,12,8,4,0,6,4,2,0,7,4,3,0,4,3,1,0
1977,Nebraska,Big 8,,12,9,3,0,7,5,2,0,7,5,2,0,4,3,1,0
1977,New Mexico,Western Athletic,,12,5,7,0,7,2,5,0,5,3,2,0,7,2,5,0
1977,New Mexico State,Missouri Valley,,11,4,7,0,5,3,2,0,6,3,3,0,5,1,4,0
1977,North Carolina,ACC,,12,8,4,0,6,5,1,0,4,3,1,0,7,5,2,0
1977,Northern Illinois,Mid-American,,11,3,8,0,7,2,5,0,5,2,3,0,6,1,5,0
1977,North Texas,FBS Independents,,11,9,2,0,4,3,1,0,4,4,0,0,7,5,2,0
1977,Northwestern,Big Ten,,11,1,10,0,9,1,8,0,5,1,4,0,6,0,6,0
1977,Northwestern State,FBS Independents,,11,6,5,0,2,1,1,0,4,3,1,0,7,3,4,0
1977,Notre Dame,FBS Independents,,12,11,1,0,6,6,0,0,5,5,0,0,6,5,1,0
1977,Ohio,Mid-American,,11,1,10,0,8,0,8,0,5,0,5,0,6,1,5,0
1977,Ohio State,Big Ten,,12,9,3,0,8,7,1,0,6,5,1,0,5,4,1,0
1977,Oklahoma,Big 8,,12,10,2,0,7,7,0,0,6,6,0,0,5,4,1,0
1977,Oklahoma State,Big 8,,11,4,7,0,7,2,5,0,5,2,3,0,6,2,4,0
1977,Ole Miss,SEC,,11,5,6,0,7,2,5,0,7,5,2,0,4,0,4,0
1977,Oregon,Pac-8,,11,2,9,0,7,1,6,0,5,1,4,0,6,1,5,0
1977,Oregon State,Pac-8,,11,2,9,0,7,0,7,0,5,2,3,0,6,0,6,0
1977,Pacific,PCAA,,11,6,5,0,4,3,1,0,6,3,3,0,5,3,2,0
1977,Penn State,FBS Independents,,12,11,1,0,7,7,0,0,7,6,1,0,4,4,0,0
1977,Pennsylvania,Ivy,,9,5,4,0,7,4,3,0,5,5,0,0,4,0,4,0
1977,Pittsburgh,FBS Independents,,12,10,2,0,10,8,2,0,7,5,2,0,4,4,0,0
1977,Prairie View,SWAC,,11,3,8,0,6,1,5,0,6,2,4,0,5,1,4,0
1977,Princeton,Ivy,,9,3,6,0,7,3,4,0,5,2,3,0,4,1,3,0
1977,Purdue,Big Ten,,11,5,6,0,8,3,5,0,6,3,3,0,5,2,3,0
1977,Rice,Southwest,,11,1,10,0,8,0,8,0,6,1,5,0,5,0,5,0
1977,Richmond,FBS Independents,,11,3,8,0,5,1,4,0,5,3,2,0,6,0,6,0
1977,Rutgers,FBS Independents,,11,8,3,0,5,2,3,0,5,4,1,0,6,4,2,0
1977,San Diego State,FBS Independents,,11,10,1,0,2,2,0,0,7,7,0,0,4,3,1,0
1977,San José State,PCAA,,11,4,7,0,4,2,2,0,5,3,2,0,6,1,5,0
1977,SMU,Southwest,,11,4,7,0,8,3,5,0,5,2,3,0,6,2,4,0
1977,South Carolina,FBS Independents,,12,5,7,0,3,2,1,0,7,4,3,0,5,1,4,0
1977,Southern,SWAC,,11,3,8,0,6,1,5,0,4,1,3,0,7,2,5,0
1977,Southern Illinois,Missouri Valley,,11,3,8,0,3,0,3,0,4,2,2,0,7,1,6,0
1977,Southern Mississippi,FBS Independents,,12,6,6,0,5,1,4,0,4,0,4,0,8,6,2,0
1977,Stanford,Pac-8,,12,9,3,0,7,5,2,0,6,6,0,0,5,2,3,0
1977,Syracuse,FBS Independents,,11,6,5,0,5,3,2,0,6,4,2,0,5,2,3,0
1977,TCU,Southwest,,11,2,9,0,8,1,7,0,6,1,5,0,5,1,4,0
1977,Temple,FBS Independents,,11,6,5,0,6,3,3,0,6,4,2,0,5,2,3,0
1977,Tennessee,SEC,,11,4,7,0,6,1,5,0,7,4,3,0,4,0,4,0
1977,Tennessee State,FBS Independents,,10,9,1,0,0,0,0,0,5,5,0,0,5,4,1,0
1977,Texas,Southwest,,12,11,1,0,8,8,0,0,7,7,0,0,4,4,0,0
1977,Texas A&M,Southwest,,12,8,4,0,8,6,2,0,5,3,2,0,6,5,1,0
1977,Texas-Arlington,Southland,,11,5,6,0,5,3,2,0,5,2,3,0,6,3,3,0
1977,Texas Southern,SWAC,,11,7,4,0,6,4,2,0,7,5,2,0,4,2,2,0
1977,Texas Tech,Southwest,,12,7,5,0,8,4,4,0,5,3,2,0,6,4,2,0
1977,The Citadel,Southern,,11,5,6,0,5,3,2,0,7,5,2,0,4,0,4,0
1977,Toledo,Mid-American,,11,2,9,0,9,2,7,0,6,1,5,0,5,1,4,0
1977,Tulane,FBS Independents,,11,3,8,0,7,2,5,0,5,2,3,0,6,1,5,0
1977,Tulsa,Missouri Valley,,11,3,8,0,4,2,2,0,4,2,2,0,7,1,6,0
1977,UCLA,Pac-8,,11,7,4,0,7,5,2,0,5,5,0,0,6,2,4,0
1977,USC,Pac-8,,12,8,4,0,7,5,2,0,6,5,1,0,5,2,3,0
1977,Utah,Western Athletic,,11,3,8,0,7,2,5,0,5,3,2,0,6,0,6,0
1977,Utah State,FBS Independents,,11,4,7,0,3,0,3,0,4,2,2,0,7,2,5,0
1977,UTEP,Western Athletic,,11,1,10,0,7,0,7,0,5,1,4,0,6,0,6,0
1977,Vanderbilt,SEC,,11,2,9,0,6,0,6,0,5,1,4,0,6,1,5,0
1977,Villanova,FBS Independents,,11,4,7,0,6,2,4,0,5,2,3,0,6,2,4,0
1977,Virginia,ACC,,11,2,9,0,6,1,5,0,6,2,4,0,5,0,5,0
1977,Virginia Tech,FBS Independents,,11,3,8,0,5,1,4,0,6,3,3,0,5,0,5,0
1977,VMI,Southern,,11,7,4,0,2,2,0,0,5,5,0,0,6,2,4,0
1977,Wake Forest,ACC,,11,1,10,0,6,0,6,0,5,1,4,0,6,0,6,0
1977,Washington,Pac-8,,12,8,4,0,7,6,1,0,6,5,1,0,5,2,3,0
1977,Washington State,Pac-8,,11,6,5,0,7,3,4,0,4,3,1,0,7,3,4,0
1977,Western Carolina,Southern,,11,7,4,0,5,3,2,0,6,4,2,0,5,3,2,0
1977,Western Michigan,Mid-American,,11,4,7,0,8,3,5,0,6,2,4,0,5,2,3,0
1977,West Texas A&M,Missouri Valley,,11,6,5,0,5,4,1,0,5,4,1,0,6,2,4,0
1977,West Virginia,FBS Independents,,11,5,6,0,8,3,5,0,6,3,3,0,5,2,3,0
1977,Wichita State,Missouri Valley,,11,5,6,0,4,3,1,0,5,3,2,0,6,2,4,0
1977,William & Mary,FBS Independents,,11,6,5,0,8,4,4,0,4,3,1,0,7,3,4,0
1977,Wisconsin,Big Ten,,11,5,6,0,9,3,6,0,6,3,3,0,5,2,3,0
1977,Wyoming,Western Athletic,,11,4,7,0,7,4,3,0,4,3,1,0,7,1,6,0
1977,Yale,Ivy,,9,7,2,0,7,6,1,0,6,4,2,0,3,3,0,0